############
#    O     #
#      P ###
#   X      #
#          # 
########   #
#    ##    #
#    ## XOO#
#    X     #
#  X       #
#     O  # #
############
